1111111111111111111111111
1CCCCCCCCCCCCCCCCCCCCCCP1
1C000011100000011111100C1
1C000111100000111001110C1
1C001101100001110000110C1
1C011001100000000001110C1
1C110001100000000111000C1
1C111111111100011100000C1
1C000001100001110000000C1
1C000001100001111111111C1
1ECCCCCCCCCCCCCCCCCCCCCC1
1111111111111111111111111