1111111111
1C000P00EP
1111111111