1111E11111
1C000P00E1
1111111111