1111111111
CC000P00E1
1111111111