1111111111111111111111111
1000100010001000100010001
1010001000100010001000101
1011111111111111111111101
1000100010001000100010001
1110101010101010101010111
1000101000100010001P10001
1011101111111111111111101
1000101000100010001000101
1110101010101010101010101
1EC0100010001000100010001
1111111111111111111111111