111111111111111
1200C020000C1P1
101101111011101
11C10000200C101
110101011110101
1E0001C00002001
111111111111111