111111111
1CC020CC1
1P10101C1
1C1CCC1C1
1C11110C1
1CC020CE1
111111111