111111111111111111
1020C002000C0002C1
111101111110110111
1C00C1CPC1C00000C1
111011101111110111
1E0000020C00020001
111111111111111111