111111111
1C00200E1
110111011
1C00P00C1
111111111