111111111111
1200000C1P01
101110111101
11C100002101
110101011101
1E0001000001
111111111111