111111111111111111
1020020200000000P1
100020000020000201
102002000000020001
120000200200000001
1EC000000020000021
111111111111111111