1111111111
1C000P00E1
11111111111