1111111111
1C000P00E11
1111111111