1111111111
1C000P0001
1111111111