1111111111
1C000PC0E1
1111111111