1111111111
1EC00P00E1
1111111111