1111111111
1CP00P00E1
1111111111